4	4	4	4	4	4	4	4	4	4	4	4	4	4	4	4	4	4	4	4	4	4	4	4	4	4	4	4	4	4
4	0	0	0	0	0	0	0	0	0	3	3	3	0	0	0	0	0	0	0	0	0	0	0	0	0	0	0	0	4
4	0	0	0	0	0	0	0	0	0	3	3	3	0	0	0	0	0	0	0	0	0	0	0	0	0	0	0	0	4
4	0	0	0	0	0	0	0	0	0	3	3	3	0	0	0	0	0	0	0	0	0	0	0	0	0	0	0	0	4
4	0	0	0	0	0	4	0	0	0	3	3	3	0	0	0	0	0	0	0	0	0	0	0	0	0	0	0	0	4
4	0	0	0	0	0	4	0	0	0	3	3	3	0	0	0	4	4	4	4	4	4	4	4	h	0	0	0	0	4
4	0	0	0	0	0	4	0	0	0	3	3	3	0	0	0	4	4	4	4	4	4	4	4	4	0	0	0	0	4
4	4	4	4	4	4	4	0	0	0	3	3	3	0	0	0	0	0	0	0	0	0	0	4	4	0	0	0	0	4
4	4	4	4	4	4	H	0	0	0	3	3	3	0	0	0	0	0	0	0	0	0	0	4	4	4	0	0	0	4
4	0	0	0	0	0	0	0	0	0	3	3	3	0	0	0	0	0	0	0	0	0	0	4	4	4	0	0	0	4
4	0	0	0	0	0	0	0	0	0	3	3	3	0	0	0	0	0	0	0	0	0	0	4	4	4	0	0	0	4
4	0	0	0	0	0	0	0	0	0	3	3	3	3	0	0	3	3	3	3	0	0	0	4	4	0	0	0	0	4
4	0	0	0	0	0	0	0	0	0	3	3	3	3	0	0	3	3	3	3	0	0	0	4	4	0	0	0	0	4
4	0	0	0	0	0	0	0	0	0	3	3	3	3	0	0	3	3	3	3	0	0	0	4	4	0	0	0	0	4
4	0	0	0	0	0	0	0	0	0	0	0	4	0	0	0	0	3	3	3	0	0	0	4	4	0	0	0	4	4
4	0	0	0	0	4	0	0	0	0	0	0	4	0	0	0	0	3	3	3	0	0	0	4	4	0	0	0	4	4
4	0	0	0	0	4	0	0	0	0	0	0	4	0	0	0	0	3	3	3	0	0	0	4	4	0	0	0	0	4
4	0	0	0	0	4	0	0	0	0	0	0	4	0	0	0	0	3	3	3	0	0	0	4	4	0	0	0	0	4
4	4	4	4	4	4	0	0	0	0	0	0	4	0	0	0	0	3	3	3	3	3	3	3	3	3	0	0	3	4
4	0	0	0	0	4	0	0	0	0	0	0	4	0	0	0	0	3	3	3	3	3	3	3	3	3	0	0	3	4
4	0	0	0	0	4	0	0	0	0	4	4	4	4	0	0	0	3	3	3	3	3	3	3	3	3	0	0	3	4
4	0	0	0	0	4	0	0	0	0	0	0	0	0	0	0	0	3	3	3	0	0	0	4	4	0	0	0	0	4
4	0	0	0	0	4	0	0	0	0	0	0	0	0	0	0	0	3	3	3	0	0	0	4	4	0	0	0	0	4
4	0	0	0	0	4	0	0	0	0	0	0	0	0	0	0	0	3	3	3	0	0	0	4	4	0	0	0	0	4
4	0	0	0	0	4	0	0	0	0	0	0	0	0	0	0	0	3	3	3	0	0	0	4	4	0	0	0	0	4
4	0	0	0	0	4	0	0	0	0	0	0	0	0	0	0	0	3	3	3	0	0	0	4	4	0	0	0	0	4
4	0	0	0	4	4	4	4	4	4	4	0	0	0	0	0	0	3	3	3	0	0	0	4	4	0	0	0	0	4
4	0	0	0	4	0	0	0	0	0	4	0	0	0	0	0	0	3	3	3	0	0	0	4	4	0	0	0	0	4
4	0	0	0	4	0	0	0	0	0	4	0	0	0	0	0	0	3	3	3	0	0	0	4	4	4	0	1	0	4
4	0	0	0	4	0	0	0	0	0	4	0	0	0	0	0	0	3	3	3	0	0	0	4	4	4	0	0	0	4
4	0	0	0	4	0	0	0	3	3	3	3	3	3	3	3	3	3	3	3	0	0	0	4	4	0	0	0	0	4
4	0	0	0	4	0	0	0	3	3	3	3	3	3	3	3	3	3	3	3	0	0	0	4	4	0	0	0	0	4
4	0	0	0	4	0	0	0	3	3	3	3	3	3	3	3	3	3	3	3	0	0	0	4	4	0	0	0	0	4
4	0	0	0	4	0	0	0	0	0	0	0	0	0	0	0	0	0	0	0	0	0	0	4	4	0	0	2	0	4
4	0	0	0	4	0	0	0	0	0	0	0	0	0	0	0	0	0	0	0	0	0	0	4	4	0	0	0	0	4
4	0	0	0	0	0	0	0	3	3	3	4	4	4	4	4	4	4	4	0	0	0	4	4	4	0	0	0	4	4
4	0	0	0	0	0	0	0	3	3	3	0	0	0	0	0	0	0	0	0	0	0	0	0	0	0	0	0	4	4
4	0	0	0	0	0	0	0	3	3	3	0	0	0	0	0	0	0	0	0	0	0	0	0	0	0	0	0	0	4
4	0	0	0	0	0	0	0	3	3	3	0	0	0	0	0	0	0	0	0	0	0	0	0	0	0	0	0	0	4
4	4	4	4	4	4	4	4	4	4	4	4	4	4	4	4	4	4	4	4	4	4	4	4	4	4	4	4	4	4
