4	4	4	4	4	4	4	4	4	4	4	4	4	4	4	4	4	4	4	4	4	4	4	4	4	4	4	4	4	4
4	0	0	0	0	0	0	0	0	0	3	3	3	0	0	0	0	0	0	0	0	0	0	0	0	0	0	0	0	4
4	0	0	0	0	0	0	0	0	0	3	3	3	0	0	0	0	0	0	0	0	0	0	0	0	0	S	0	0	4
4	0	S	0	0	0	0	0	0	0	3	3	3	0	0	0	0	0	0	0	0	0	0	0	0	0	0	0	0	4
4	0	0	0	0	0	4	0	0	0	3	3	3	0	0	0	0	0	0	0	0	0	0	0	0	0	0	0	0	4
4	0	0	0	0	0	4	0	0	0	3	3	3	0	0	0	4	4	4	4	4	4	4	4	4	0	0	0	0	4
4	0	0	0	0	0	4	0	0	0	3	3	3	0	0	0	4	4	4	4	4	4	4	4	4	0	0	0	0	4
4	4	4	4	4	4	4	0	0	0	3	3	3	0	0	0	0	0	0	0	0	0	0	4	4	0	0	0	0	4
4	4	4	4	4	4	4	0	0	0	3	3	3	0	0	0	0	0	0	0	0	0	0	4	4	4	0	0	S	4
4	0	0	0	0	0	0	0	0	0	3	3	3	0	0	0	0	0	0	0	0	0	0	4	4	4	0	0	0	4
4	0	0	0	0	0	0	0	0	0	3	3	3	0	0	0	0	0	0	0	0	0	0	4	4	4	0	0	0	4
4	0	0	0	0	0	0	0	S	0	3	3	3	3	0	0	3	3	3	3	0	0	0	4	4	0	0	0	0	4
4	0	0	S	0	0	0	0	0	0	3	3	3	3	0	0	3	3	3	3	0	0	0	4	4	0	0	S	0	4
4	0	0	0	0	0	0	0	0	0	3	3	3	3	0	0	3	3	3	3	0	0	0	4	4	0	0	0	0	4
4	0	0	0	0	0	0	0	0	0	0	0	4	0	0	0	0	3	3	3	0	0	0	4	4	0	0	0	4	4
4	0	0	0	0	4	0	0	0	0	0	0	4	0	0	0	0	3	3	3	0	0	0	4	4	0	0	0	4	4
4	0	0	0	0	4	0	0	0	0	0	0	4	0	S	0	0	3	3	3	0	0	0	4	4	0	0	0	0	4
4	0	0	0	0	4	0	0	0	0	0	0	4	0	0	0	0	3	3	3	0	0	0	4	4	0	0	0	0	4
4	4	4	4	4	4	0	2	0	0	0	0	4	0	0	0	0	3	3	3	3	3	3	3	3	3	0	0	3	4
4	0	0	0	0	4	0	0	0	0	0	0	4	0	0	0	0	3	3	3	3	3	3	3	3	3	0	0	3	4
4	0	0	0	0	4	0	0	0	0	4	4	4	4	0	0	0	3	3	3	3	3	3	3	3	3	0	0	3	4
4	0	0	0	0	4	0	0	0	0	0	0	0	0	0	0	0	3	3	3	0	0	0	4	4	0	0	0	0	4
4	0	0	0	0	4	0	0	0	0	0	S	0	0	0	0	0	3	3	3	0	0	0	4	4	0	0	0	0	4
4	0	0	0	0	4	0	0	0	0	0	0	0	0	0	0	0	3	3	3	0	0	0	4	4	0	0	0	0	4
4	0	0	0	0	4	0	1	0	0	0	0	0	0	0	0	0	3	3	3	0	0	0	4	4	0	0	0	0	4
4	0	0	0	0	4	0	0	0	0	0	0	0	0	0	0	0	3	3	3	0	0	0	4	4	0	0	0	0	4
4	0	0	0	4	4	4	4	4	4	4	0	0	0	0	0	0	3	3	3	0	0	0	4	4	0	0	0	0	4
4	0	0	0	4	0	0	0	0	0	4	0	0	0	0	0	0	3	3	3	0	0	0	4	4	0	0	0	0	4
4	0	0	0	4	0	0	0	0	0	4	0	0	0	0	0	0	3	3	3	0	0	0	4	4	4	0	0	0	4
4	0	0	0	4	0	0	0	0	0	4	0	0	0	0	0	0	3	3	3	0	0	0	4	4	4	0	0	0	4
4	0	0	0	4	0	0	0	3	3	3	3	3	3	3	3	3	3	3	3	0	0	0	4	4	0	0	0	0	4
4	0	0	0	4	0	0	0	3	3	3	3	3	3	3	3	3	3	3	3	0	0	0	4	4	0	0	0	0	4
4	0	0	0	4	0	0	0	3	3	3	3	3	3	3	3	3	3	3	3	0	0	0	4	4	0	0	0	0	4
4	0	0	0	4	0	0	0	0	0	0	0	0	0	0	0	0	0	0	0	0	0	0	4	4	0	0	0	0	4
4	0	0	0	4	0	0	0	0	0	0	0	0	0	0	0	0	0	0	0	0	0	0	4	4	0	0	0	0	4
4	0	S	0	0	0	0	0	3	3	3	4	4	4	4	4	4	4	4	0	0	0	4	4	4	0	S	0	4	4
4	0	0	0	0	0	0	0	3	3	3	0	0	0	0	0	0	0	0	0	0	0	0	0	0	0	0	0	4	4
4	0	0	0	0	0	0	0	3	3	3	0	0	0	0	0	0	0	0	0	0	0	0	0	0	0	0	0	0	4
4	0	0	0	0	0	0	0	3	3	3	0	0	0	0	0	0	0	0	0	0	0	0	0	0	0	0	0	0	4
4	4	4	4	4	4	4	4	4	4	4	4	4	4	4	4	4	4	4	4	4	4	4	4	4	4	4	4	4	4
