4	4	4	4	4	4	4	4	4	4	4	4	4	4	4	4	4	4	4	4	4	4	4	4	4	4	4	4	4	4
4	0	0	0	0	0	0	0	0	0	3	3	3	0	0	0	0	0	0	0	0	0	0	0	0	0	0	0	0	4
4	0	0	0	0	0	0	0	0	0	3	3	3	0	0	0	0	0	0	0	0	0	0	0	0	0	0	E	0	4
4	0	0	S	0	0	0	0	0	0	3	3	3	0	0	0	0	0	0	0	0	0	0	0	0	0	0	0	0	4
4	0	0	0	0	0	4	S	0	0	3	3	3	0	0	0	0	0	0	0	0	0	0	0	0	0	0	0	0	4
4	0	0	0	0	0	4	0	0	0	3	3	3	0	0	0	4	4	4	4	4	4	4	4	4	0	0	0	0	4
4	0	0	0	0	0	4	0	0	0	3	3	3	0	0	0	4	4	4	4	4	4	4	4	4	0	0	0	0	4
4	4	4	4	4	4	4	S	0	0	3	3	3	0	0	0	0	0	0	0	0	0	0	4	4	0	0	0	0	4
4	4	4	4	4	4	4	0	0	0	3	3	3	0	0	0	0	0	0	0	0	0	0	4	4	4	0	0	0	4
4	0	0	0	0	0	0	0	0	0	3	3	3	0	0	0	0	0	0	0	0	0	0	4	4	4	0	0	0	4
4	0	0	0	0	a	0	0	0	0	3	3	3	0	0	0	0	0	0	0	0	0	0	4	4	4	0	0	0	4
4	0	0	0	0	0	0	0	0	0	3	3	3	3	0	0	3	3	3	3	0	0	0	4	4	0	0	0	0	4
4	0	u	0	0	0	0	0	0	0	3	3	3	3	0	0	3	3	3	3	0	0	0	4	4	0	0	0	0	4
4	0	0	0	0	0	0	0	0	0	3	3	3	3	0	0	3	3	3	3	0	0	0	4	4	0	0	0	0	4
4	0	0	0	0	0	0	0	0	0	0	0	4	0	0	0	0	3	3	3	0	0	0	4	4	0	0	0	4	4
4	0	0	0	0	4	0	0	0	0	0	0	4	0	0	0	0	3	3	3	0	0	0	4	4	0	0	0	4	4
4	0	0	0	0	4	0	0	0	E	0	0	4	0	0	0	0	3	3	3	0	0	0	4	4	0	0	0	0	4
4	0	0	0	0	4	0	0	0	0	0	0	4	0	0	S	0	3	3	3	0	0	0	4	4	0	0	0	0	4
4	4	4	4	4	4	0	2	0	0	0	0	4	0	0	0	0	3	3	3	3	3	3	3	3	3	0	0	3	4
4	0	0	0	0	4	0	0	0	0	0	0	4	0	0	0	0	3	3	3	3	3	3	3	3	3	0	0	3	4
4	0	0	0	0	4	0	0	0	0	4	4	4	4	0	S	0	3	3	3	3	3	3	3	3	3	0	0	3	4
4	0	E	0	0	4	0	0	0	0	0	0	0	0	0	0	0	3	3	3	0	0	0	4	4	0	0	0	0	4
4	0	0	0	0	4	0	0	0	0	0	0	0	0	0	0	0	3	3	3	0	0	0	4	4	0	0	0	0	4
4	0	0	0	0	4	0	0	0	0	0	0	u	0	0	0	0	3	3	3	0	0	0	4	4	0	0	0	0	4
4	0	0	0	0	4	0	1	0	0	0	0	0	0	0	S	0	3	3	3	0	0	0	4	4	0	0	0	0	4
4	0	0	0	0	4	0	0	0	0	0	0	0	0	0	0	0	3	3	3	0	0	0	4	4	0	0	0	0	4
4	0	0	0	4	4	4	4	4	4	4	0	0	0	0	0	0	3	3	3	0	0	0	4	4	0	0	0	0	4
4	0	0	0	4	0	0	0	0	0	4	0	A	0	0	S	0	3	3	3	0	0	0	4	4	0	0	0	0	4
4	0	0	0	4	0	0	0	0	0	4	0	0	0	0	0	0	3	3	3	0	0	0	4	4	4	0	0	0	4
4	0	0	0	4	0	0	0	0	0	4	0	0	0	0	0	0	3	3	3	0	0	0	4	4	4	0	0	0	4
4	0	0	0	4	0	0	0	3	3	3	3	3	3	3	3	3	3	3	3	0	0	0	4	4	0	0	0	0	4
4	0	0	0	4	0	0	0	3	3	3	3	3	3	3	3	3	3	3	3	0	0	0	4	4	0	0	0	0	4
4	0	0	0	4	0	0	0	3	3	3	3	3	3	3	3	3	3	3	3	0	0	0	4	4	0	0	0	0	4
4	0	0	0	4	0	0	0	0	0	0	0	0	0	0	0	0	0	0	0	0	0	0	4	4	0	0	0	0	4
4	0	0	0	4	0	0	0	0	0	0	0	0	0	0	0	0	0	0	0	0	0	0	4	4	0	0	0	0	4
4	0	0	0	0	0	0	0	3	3	3	4	4	4	4	4	4	4	4	0	0	0	4	4	4	0	0	0	4	4
4	0	A	0	0	0	0	0	3	3	3	0	0	0	0	0	0	0	0	a	0	0	0	0	0	0	0	0	4	4
4	0	0	0	0	0	0	0	3	3	3	0	0	0	0	0	0	0	0	0	0	0	0	0	0	0	0	0	0	4
4	0	0	0	0	0	0	0	3	3	3	0	0	0	0	0	0	0	0	0	0	0	0	0	0	0	0	0	0	4
4	4	4	4	4	4	4	4	4	4	4	4	4	4	4	4	4	4	4	4	4	4	4	4	4	4	4	4	4	4
