4	4	4	4	4	4	4	4	4	4	4	4	4	4	4	4	4	4	4	4	4	4	4	4	4	4	4	4	4	4
4	0	0	0	0	0	0	0	0	0	3	3	3	0	0	0	0	0	0	0	0	0	0	0	0	0	0	0	0	4
4	0	0	0	0	0	0	0	0	0	3	3	3	0	0	0	0	0	0	0	0	0	0	0	0	0	M	0	0	4
4	0	0	1	0	0	0	0	2	0	3	3	3	0	0	0	0	0	0	0	0	0	0	0	0	0	0	0	0	4
4	0	0	0	0	0	4	0	0	0	3	3	3	0	0	0	0	0	0	0	0	0	0	0	0	0	0	0	0	4
4	0	0	0	0	0	4	0	0	0	3	3	3	0	0	0	4	4	4	4	4	4	4	4	4	0	0	0	0	4
4	0	0	0	0	0	4	0	0	0	3	3	3	0	0	0	4	4	4	4	4	4	4	4	4	0	0	0	0	4
4	4	4	4	4	4	4	0	0	0	3	3	3	0	0	0	0	0	0	0	0	0	0	4	4	0	0	0	0	4
4	4	4	4	4	4	4	0	0	0	3	3	3	0	m	0	0	0	0	0	0	0	0	4	4	4	0	0	0	4
4	0	0	0	0	0	0	0	0	0	3	3	3	0	0	0	0	0	0	0	0	0	0	4	4	4	0	0	0	4
4	0	0	0	0	0	0	0	0	0	3	3	3	0	0	0	0	0	0	0	0	0	0	4	4	4	0	0	0	4
4	0	0	0	0	0	0	0	0	0	3	3	3	3	0	0	3	3	3	3	0	0	0	4	4	0	0	0	0	4
4	0	0	0	0	0	0	0	0	0	3	3	3	3	0	0	3	3	3	3	0	0	0	4	4	0	0	0	0	4
4	0	M	0	0	0	0	0	0	0	3	3	3	3	0	0	3	3	3	3	0	0	0	4	4	0	0	0	0	4
4	0	0	0	0	0	0	0	0	0	0	0	4	0	0	0	0	3	3	3	0	0	0	4	4	0	0	0	4	4
4	0	0	0	0	4	0	0	0	0	0	0	4	0	0	0	0	3	3	3	0	0	0	4	4	0	0	0	4	4
4	0	0	0	0	4	0	0	m	0	0	0	4	0	0	0	0	3	3	3	0	0	0	4	4	0	0	0	0	4
4	0	0	0	0	4	0	0	0	0	0	0	4	0	0	0	0	3	3	3	0	0	0	4	4	0	0	0	0	4
4	4	4	4	4	4	0	0	0	0	0	0	4	0	0	0	0	3	3	3	3	3	3	3	3	3	0	0	3	4
4	0	0	0	0	4	0	0	0	0	0	0	4	0	0	0	0	3	3	3	3	3	3	3	3	3	0	0	3	4
4	0	0	0	0	4	0	0	0	0	4	4	4	4	0	0	0	3	3	3	3	3	3	3	3	3	0	0	3	4
4	0	0	0	0	4	0	0	0	0	0	0	0	0	0	0	0	3	3	3	0	0	0	4	4	0	0	0	0	4
4	0	0	0	0	4	0	0	0	0	0	0	0	0	0	0	0	3	3	3	0	0	0	4	4	0	0	0	0	4
4	0	0	0	0	4	0	0	0	0	0	0	0	0	0	0	0	3	3	3	0	0	0	4	4	0	0	0	0	4
4	0	0	0	0	4	0	0	0	0	0	0	0	0	0	0	0	3	3	3	0	0	0	4	4	0	0	0	0	4
4	0	0	0	0	4	0	0	0	0	0	0	0	0	M	0	0	3	3	3	0	0	0	4	4	0	0	0	0	4
4	0	0	0	4	4	4	4	4	4	4	0	0	0	0	0	0	3	3	3	0	0	0	4	4	0	0	0	0	4
4	0	0	0	4	0	0	0	0	0	4	0	0	0	0	0	0	3	3	3	0	0	0	4	4	0	0	0	0	4
4	0	0	0	4	0	0	0	0	0	4	0	0	0	0	0	0	3	3	3	0	0	0	4	4	4	0	0	0	4
4	0	0	0	4	0	0	0	0	0	4	0	0	0	0	0	0	3	3	3	0	0	0	4	4	4	0	0	0	4
4	0	0	0	4	0	0	0	3	3	3	3	3	3	3	3	3	3	3	3	0	0	0	4	4	0	0	0	0	4
4	0	0	0	4	0	0	0	3	3	3	3	3	3	3	3	3	3	3	3	0	0	0	4	4	0	0	0	0	4
4	0	0	0	4	0	0	0	3	3	3	3	3	3	3	3	3	3	3	3	0	0	0	4	4	0	0	0	0	4
4	0	M	0	4	0	0	0	0	0	0	0	0	0	0	0	0	0	0	0	0	0	0	4	4	0	0	0	0	4
4	0	0	0	4	0	0	0	0	0	0	0	0	0	0	0	0	0	0	0	0	0	0	4	4	0	0	0	0	4
4	0	0	0	0	0	0	0	3	3	3	4	4	4	4	4	4	4	4	0	0	0	4	4	4	0	m	0	4	4
4	0	0	0	0	0	0	0	3	3	3	0	0	0	0	0	0	0	0	0	0	0	0	0	0	0	0	0	4	4
4	0	0	0	0	0	0	0	3	3	3	0	0	0	0	0	0	0	0	0	0	0	0	0	0	0	0	0	0	4
4	0	0	0	0	0	0	0	3	3	3	0	0	0	0	0	0	0	0	0	0	0	0	0	0	0	0	0	0	4
4	4	4	4	4	4	4	4	4	4	4	4	4	4	4	4	4	4	4	4	4	4	4	4	4	4	4	4	4	4
